7 7
0 1 1 1 1 1 1 
1 1 2 2 3 2 1
1 2 5 2 1 2 1
1 2 3 5 2 2 1     //FASE 1
1 2 2 1 5 1 1
1 3 2 4 2 1 0   
1 1 1 1 1 1 0


7 7
1 1 1 1 1 1 1
1 5 2 2 3 2 1 
1 2 1 5 1 2 1
1 2 2 2 7 2 1     //FASE 2
1 5 7 7 2 1 1
1 2 2 1 1 1 0
1 1 1 1 0 0 0

7 8
1 1 1 0 1 1 1
1 5 1 1 1 5 1
1 2 1 2 2 5 1     
1 2 7 7 2 3 1     
1 2 2 7 2 2 1     //FASE 3
1 2 2 1 2 2 1
1 2 2 1 1 1 1
1 1 1 1 0 0 0